XXXXXXXXXXXXX
XZZZ ZZZ ZZZX
XZSZSZSZSZSZX
XZSZSZSZSZSZX
XZSZSZSZSZSZX
XZSZSZSZSZSZX
XZSZSZSZSZSZX
XZSZSZSZSZSZL
XZSZSZSZSZSZL
XZSZSZSZSZSZL    
XZSZSZSZSZSZL
XZSZSZSZSZSZX
XZSZSZSZSZSZX
XZSZSZSZSZSZX
XZSZSZSZSZSZX
XZSZSZSZSZSZX
XZSZSZSZSZSZX
XZSZSZSZSZSZX
XZ ZZZ ZZZ ZX
XB       EZZX
XXXXXXXXXXHHX
